{
  "maps": [
    "5Fmdx5",
    "C7w15p",
    "2kw0nX",
    "42nG01",
    "4Kn8QH",
    "DtTYMx",
    "9R1C4v",
    "54pTpp",
    "AvVrfX",
    "0Kvr8C",
    "0QKNcV",
    "AqCM2x",
    "5AuEKn",
    "5X3cTu",
    "5183DY",
    "2xwQ2w",
    "E5ekWA",
    "E3rkAa",
    "9Dv99V",
    "EVYY0m",
    "DW8a8e",
    "8F0T2d",
    "9Rkek6",
    "AC0H2Y",
    "4W7cWM",
    "7ph1A0",
    "EY2RwQ",
    "CkuNQv",
    "16WQ73",
    "4iXGmq",
    "2jdmk7",
    "EAG2Tk",
    "6mTi7d",
    "CKahrc",
    "160xG6",
    "8dUK6N",
    "9d0aFK",
    "83QQC1",
    "487RWU",
    "Adc51t",
    "4Qphy3",
    "478XT2",
    "3YRiQ3",
    "DVwTCy",
    "2XYHAQ",
    "6HGfK5",
    "DdpQdT",
    "AX1r6f",
    "4drdPe",
    "ECFy5W",
    "572WMa",
    "3xCUuc",
    "3GrKuD",
    "20wHxq",
    "3Jky0F",
    "53h9mk",
    "3Y4dGF",
    "1xMGGM",
    "4Gx3FV",
    "7NuwPu",
    "7kvWC4",
    "5nFX86",
    "4Kr3wC",
    "29MD15",
    "D6p6aR",
    "CHxm0k",
    "1c399T",
    "9TcuEu",
    "2CdyXX",
    "EGunjr",
    "7YY8xR",
    "2a5WeY",
    "7KYMFY",
    "6mCdnM",
    "7cRt2c",
    "Ct2Dv8",
    "3Jftm8",
    "AeqYXi",
    "C5Ryf3",
    "DmjpYW",
    "9xGyqu",
    "9FmA7W",
    "1QKiq1",
    "CmuxvG",
    "D788vf",
    "2RMCD2",
    "9UN0JH",
    "EefHmn",
    "1vTx5d",
    "9d54T2",
    "6EVpuu",
    "31N2we",
    "4X02WJ",
    "7KE9KD",
    "29uqR6",
    "4hC30a",
    "1jEN74",
    "79QyrW",
    "1cvX71",
    "1qcViT",
    "6AkqNU",
    "6rDpFF",
    "2NqYCC",
    "CAfAAv",
    "6VDuh3",
    "6yarpw"
  ]
}
